WBBBBBBBBBBBBBBBBBBBBBBBBBBBBBBBBBBBBBBBBBBBBBBBBB
WBBBBBBBBBBBBBBBBBBBBBBBBBBBBBBBBBBBBBBBBBBBBBBBBB
WBBBBBBBBBBBBBBBBBBBBBBBBBBBBBBBBBBBBBBBBBBBBBBBBB
WBBBBBBBBBBBBBSBBBBBBBBBBBBBBBBBBBBBBBBBBBBBBBBBBB
WBBBBBBBBBBBBBPBBBBBBBBBBBBBBBBBBBBBBBBBBBBBBBBBBB
WBBBBBBBBBBBBBBBBBBBBBBBBBBBBBBBBBBBBBBBBBBBBBBBBB
WBBBBSBBBBBBBBBBBBBBBBBBBBBBBBBBBBBBBBBBBBBBBBBBBB
WBBBBPBBBBBBBBBBBBBBBBBBBBBBBBBBBBBBBBBGBBBBeBBBBB
WBBBBBBBBBBBBBBBBBBBBBBBBBBBBBBBBBBBBBBPBBPBBPBBBB
WBBBBBBBBHBBBBBBBBBBBBBBBBBBBBBBBBBBBBBBBBBBBBBBBB
WBBBBBBBBPBBBBBBBBBBBBBBBBBBBBBBBBBBBBBBBBBBBBBBBB
WBBBBBBBBBBBBBBBBBBBBlBBBBBBmBBBBBBBBBrBBBBBBBBBBB
WBBBBBBBBBBBBBBBBBBBBBBBBBBBBBBBBBBBBBBBBBBBBSBBBB
WBBBBBBBBBBBBBBBBBSBBBBBBBBBBBBBBBBBBBBBBBPBBPBBPB
WBBBBBBBBBBBBBBBBPBBPBBBBBBBBBBBBBBBBBBBBEBBBBBBBB
WBBBBBBBBBBBBBBBBBBBBBBBBBBBBBBBBBBBBBBBBBBBBBBBBB
WB1BBBBBBBBBBBBBBBBBBBBBBBBBBBBBBBBBBBBBBBBBBBBBBB
WBBBBBBBBBBBBMMBBBBBBGGBBBMBSBMMMGBBBBBBBBBBTBBBBB
PBBPBBPBBPBBPBBPBBPBBPBBBBBPBBPBBPBBBBBBBPBBPBBPBB
vBBvBBvBBvBBvBBvBBvBBvBBBBBvBBvBBvBBBBBBBvBBvBBvBB



