BBBBBBBBBBBBBBBBBBBBBBBBBBBBBBBBBBBBBBBBBBBBBBBBBBBBBBBBBBBBBBBBBBBBBBBBBBBBBBBBBBBBBBBBBBBBBBBBBBBBBBBBBBBBBBBBv
BBBBBBBBBBBBBBBBBBBBBBBBBBBBBBBBBBBBBBBBBBBBBBBBBBBBBBBBBBBBBBBBBBBBBBBBBBBBBBBBBBBBBBBBBBBBBBBBBBBBBBBBBBBBBBBBv
BBBBBBBBBBBBBBBBBBBBBBBBBBBBBBBBBBBBBBBBBBBBBBBBBBBBBBBBBBBBBBBBBBBBBBBBBBBBBBBBBBBBBBBBBBBBBBBBBBBBBBBBBBBBBBBBv
WBBBBBBBBBBBBBBSSSSBBBBBBBBBBBBBBBBBBBBBBBBBBBBBBBBBBBBBBBBBBBBBBBBBBBBBBBBBBBBBBBBBBBBBBBBBBBBBBBBBBBBBBBBBBBBBv
WBBBBBBBBBPBBPBBPBBPbbBBBBBBBBBBBBBBBBBBGBBBBBBBBBBBBBBBBBBBBBBBBBBBBBBBBBBBBBBBBBBBBBBBBBBBBBBBBBBBBBBBBBBBBBBBv
WBBBBBBBBBBBBBBBBBBBBlBBBBBBBBBBBBBBBBBBmBBBBBBBBBBBBBBrBBBBBBBBBBBBBBBBBBBBBBBBBBBBBBBBBBBBBSSBBBSSBBBBBBBBBGBBv
WBBBBBBBBBBBBBBBBBBBBBBBBBBBBBBBBBBBBBBBBBBBBBBBBBBBBBBBPBBPBBPBBPBlBBBBBBBBBBBmBBBBBBBBBBrPBBPBBPBBPBBBBBBBBPBBv
WBBBBBBBBBBBBBBBBBBBBBBBBBBBBBBBBBBBBBBBBBBBBBBBBBBBBBBBBBBBBBBBBBBBBBBBBBBBBBBBBBBBBBBBBBBBBBBBBBBBBBBBBBBBBBBBv
WBBBBBBBBBBBBBBBPBBPBBBBBBBBBBBBBBBBBSSGBBBBSSBBBBBBBBBBBBBBBBBBBBBBdBBBBBBBBBBBBBBBBBBBBBBBBBBBBBBBBBBBBBBBBBBBv
WBBBBBBBBBBBBBBBBBBBBBBBBBBBBBBBBBBBPBBPBBPBBPBBPBBdBBBBBBBBBBBBBBBBBBBBBBBBBBBBBBBBBBBBBBBBBBBBBBBBBBBBBBBBBeBBv
WBBBBBBBBBBBBBBBBBBBBBBBBBBBBBBBBBBBBBBBBBBBBBBBBBBBBBBBBBBBBBBBBBBBBBBBBBBBBBBBBBBBSBBBBBBBBBBBBBBBBBBBBBPBBPBBv
WBBBBBBBBBBBBBBSBMMMBSSBBBBBBBBBBBBBBBBBBBBBBBBBBBBBBBBBBBBBBBBBBBBBBBBBBBBBBBBBBBBBPBBBBBBBBBBBBBBBBBBBBEBBBBBBv
WBBBBBBBBBBBPBBPBBPBBPBBPBBPBBPBBBBBBBBBBBBBBBBBBBBBBBBBBBBBBBBBBBBBBBBBBBBBBBBBBBBBBBBBBBBBBBBBBBBBBBBBBBBBBBBBv
WBBBBBBBBBBBBBBBBBBBBBBBBBBBBBBBBBBBBBBBBBBBBBBBBBBBBBBBBBBBBBBBBBBBBBBBBBBBBBBBBBBBBBBBBBBBBBBBBBBBBBBBBBBBBBBBv
WBBBBBBBBBBBBBBBBBBBBBBBBBBBBBBBBBBBBBBBBBBBBBBBBBBBBBBBBBBBBBBBBBBBBBBBBBBBBBBBBBBBBBBBBBBBBBBBBBBBBBBBBBBBTBBBv
WBBBBBBBBBBBBBBBBBBBBBBBBBBBBBBBBBBBBBBBBBBBBBBBBBBBBBBBBBBBBBBBBBBBBGBBBBBBBBBBBBBBBBBBBSBBBBBBBBBBBBBBBBPBBPBBv
WBBBBBBBPBBBBBBBBBBBBBBBBBBBBBBBBBBBBBBBBBBBBBBBBBBBBBBBBBBBBBBBBBBBBDBBBBBBBBBBBBBBBBBBBPBBBBBBBBBBBBBBBBBBBBBBv
WBBBBBBBBBBBBBBBBBBBBBBBBBBBBBBBBBBBBBBBBBBBBBBBBBBHBBBBBBBBBBBBBBBBBBBBBBBBBBBBBBBBBBBBBBBBBBBBBBBBBBBBBBBBBBBBv
WBBBBBBBBBBBBBBBBBBBBBBBBBBBBBBBBBBBBBBBBBBBBBBBBBBDBBBBBBBBBBBBBBBBBBBBBBBBBBBBBBBBBBBBBBBBBBBBBBBBBBBBBBBBBBBBv
WBB1BBBBBBBBBBBBBBBBBBBBBBBBBBBBBBBBBBBBBBBBBBBBBBBuBBBBBBBBBBBBBBBBBuBBBBBBBBBBBBBBBBBBBBBBBBBBBBBBBBBBBBBBBBBBv
WBBBBBBBBBBBBBBBMMMBBSSSSSBBMMMBBBBlBBBBmBBBrBBBBBBBBBBBBBGBBRBGBBBMMMBBBBSSSBBBBBBBBBBBBBBBBBBBBBBBBBBBRBSSGBBBv
PBBPBBPBBPBBPBBPBBPBBPBBPBBPBBPBBPBBBBBBBBBBBPBBPBBPBBPBBPBBPBBPBBPBBPBBPBBPBBPBlBBBBBBBBmBBBBBBBBBBBBrPBBPBBPBBv
vBBvBBvBBvBBvBBvBBvBBvBBvBBvBBvBBvBBBBBBBBBBBvBBvBBvBBvBBvBBvBBvBBvBBvBBvBBvBBvBBBBBBBBBBBBBBBBBBBBBBBBBBBBBBBBBv
vBBvBBvBBvBBvBBvBBvBBvBBvBBvBBvBBvBBBBBBBBBBBvBBvBBvBBvBBvBBvBBvBBvBBvBBvBBvBBvBBBBBBBBBBBBBBBBBBBBBBBBBBBBBBBBBv


