WBBBBBBBBBBBBBBBBBBBBBBBBBBBBBBBBBBBBBBBBBBBBBBBB
WBBBBBBBBBBBBBBBBBBBBBBBBBBBBBBBBBBBBBBBBBBBBBBBB
WBBBBBBBBBBBBBBBBBBBBBBBBBBBBBBBBBBBBBBBBBBBBBBBB
WBBBBBBBBBBBBBBBBBBBBBBBBBBBBBBBBBBBBBBBBBBBBBBBB
WBBBBBBBBBBBBBBBBBSS1BBBBBBBBBBBBBBBBBBBBBBBBBBBB
WBBBBBBBBBBBBBBBBPBBPBBBBBBBBBBBBBBBBBBBBBBBBBBBB
WBBBBBBBBBBBBBBBBBBBBBBBBBBBBBBBBBBBBBBBBBBBBBBBB
WBBBBBBBBBBBBBBBBBBBBBBBBBBBBBBBBBBBBBBBBBBBBBBBB
WPBlBBBBBBBBBBBBBBBBmBBBBBBBBBBBBBBBBBrPBBBBBBBBP
WpBBBBBBBBBBBBBBBBBBBBBBBBBBBBBBBBBBBBBBBBBBBBBBB
WpBBBBBBBBBBBBBBBBBBBBBBBBBBBBBBBBBBBBBBBBBBBBBBB
WpBMMMMMMMMMMMMMMMMMMMMMMMMMMMMMMBBBBBBBBBBBBBBBB
W2BB2BB2BB2BB2BB2BB2BB2BB2BB2BB2BBBBBBBBBBBBBBBBB
WBBBBBBBBBBBBBBBBBBBBBBBBBBBBBBBBBBBBBBBBBBBBBBBB
WBBBBBBBBBBBBBBBBBBBBBBBBBBBBBBBBBBBBBBBBBBBBBBBB
WBBBBBBBBBBBBBBBBBBBBBBBBBBBBBBBBBBBBBBBBBBBBBBBB
WBBBBBBBBBBBBBBBBBBBBBBBBBBBBBBBBBBBBBBBBBBBBBBBB
WBBBBBBBBBBBBBBBBBBBBBBBBBBBBBBBBBBBBBBBBBBBBBBBB
WBTBBBBBBBBBBBBBBBBBBBBBBBBBBBBBBBBBBBBBBBBBBBBBB
WPBBPBBBBBBBBBBBBBBBBBBBBBBBBBBBBBBPBBPBBBBBBBBBB
WpBBpBBBBBBBBBBBBBBBBBBBBBBBBBBBBBBpBBpBBBBBBBBBB
WpBBpBlBBBBBBBBBBBBBBmBBBBBBBBBBBBrpBBpBBBBBBBBBB
WpBBpBBBBBBBBBBBBBBBBBBBBBBBBBBBBBBpBBpBBBBBBBBBB
WpBBpBBBBBBBBBBBBBBBBBBBBBBBBBBBBBBpBBpBBBBBBBBBB
W2BB2BBBBBBBBBBBBBBBBBBBBBBBBBBBBBB2BB2BBBBBBBBBB