BBBBBBBBBBBBBBBBBBBBBBBBBBBBBBBBBBBBBBBBBBBBBBBBBBBBBBBBBBBBBBBBBBBBBBBBBBBBBBBBBBBBBBBBBBBBBBBBBBBBBBBBBBBBBBBBv
BBBBBBBBBBBBBBBBBBBBBBBBBBBBBBBBBBBBBBBBBBBBBBBBBBBBBBBBBBBBBBBBBBBBBBBBBBBBBBBBBBBBBBBBBBBBBBBBBBBBBBBBBBBBBBBBv
BBBBBBBBBBBBBBBBBBBBBBBBBBBBBBBBBBBBBBBBBBBBBBBBBBBBBBBBBBBBBBBBBBBBBBBBBBBBBBBBBBBBBBBBBBBBBBBBBBBBBBBBBBBBBBBBv
BBBBBBBBBBBBBBBSSSSBBBBBBBBBBBBBBBBBBBBBBBBBBBBBBBBBBBBBBBBBBBBBBBBBBBBBBBBBBBBBBBBBBBBBBBBBBBBBBBBBBBBBBBBBBBBBv
BBBBBBBBBBPBBPBBPBBPbbBBBBBBBBBBBBBBBBBBGBBBBBBBBBBBBBBBBBBBBBBBBBBBBBBBBBBBBBBBBBBBBBBBBBBBBBBBBBBBBBBBBBBBBBBBv
BBBBBBBBBBBBBBBBBBBBBlBBBBBBBBBBBBBBBBBBmBBBBBBBBBBBBBBrBBBBBBBBBBBBBBBBBBBBBBBBBBBBBBBBBBBBBSSBBBSSBBBBBBBBBGBBv
BBBBBBBBBBBBBBBBBBBBBBBBBBBBBBBBBBBBBBBBBBBBBBBBBBBBBBBBPBBPBBPBBPBlBBBBBBBBBBBmBBBBBBBBBBrPBBPBBPBBPBBBBBBBBPBBv
BBBBBBBBBBBBBBBBBBBBBBBBBBBBBBBBBBBBBBBBBBBBBBBBBBBBBBBBBBBBBBBBBBBBBBBBBBBBBBBBBBBBBBBBBBBBBBBBBBBBBBBBBBBBBBBBv
BBBBBBBBBBBBBBBBPBBPBBBBBBBBBBBBBBBBBSSGBBBBSSBBBBBBBBBBBBBBBBBBBBBBdBBBBBBBBBBBBBBBBBBBBBBBBBBBBBBBBBBBBBBBBBBBv
BBBBBBBBBBBBBBBBBBBBBBBBBBBBBBBBBBBBPBBPBBPBBPBBPBBdBBBBBBBBBBBBBBBBBBBBBBBBBBBBBBBBBBBBBBBBBBBBBBBBBBBBBBBBBeBBv
BBBBBBBBBBBBBBBBBBBBBBBBBBBBBBBBBBBBBBBBBBBBBBBBBBBBBBBBBBBBBBBBBBBBBBBBBBBBBBBBBBBBSBBBBBBBBBBBBBBBBBBBBBPBBPBBv
BBBBBBBBBBBBBBBSBMMMBSSBBBBBBBBBBBBBBBBBBBBBBBBBBBBBBBBBBBBBBBBBBBBBBBBBBBBBBBBBBBBBPBBBBBBBBBBBBBBBBBBBBEBBBBBBv
BBBBBBBBBBBBPBBPBBPBBPBBPBBPBBPBBBBBBBBBBBBBBBBBBBBBBBBBBBBBBBBBBBBBBBBBBBBBBBBBBBBBBBBBBBBBBBBBBBBBBBBBBBBBBBBBv
BBBBBBBBBBBBBBBBBBBBBBBBBBBBBBBBBBBBBBBBBBBBBBBBBBBBBBBBBBBBBBBBBBBBBBBBBBBBBBBBBBBBBBBBBBBBBBBBBBBBBBBBBBBBBBBBv
WBBBBBBBBBBBBBBBBBBBBBBBBBBBBBBBBBBBBBBBBBBBBBBBBBBBBBBBBBBBBBBBBBBBBBBBBBBBBBBBBBBBBBBBBBBBBBBBBBBBBBBBBBBBTBBBv
WBBBBBBBBBBBBBBBBBBBBBBBBBBBBBBBBBBBBBBBBBBBBBBBBBBBBBBBBBBBBBBBBBBBBGBBBBBBBBBBBBBBBBBBBSBBBBBBBBBBBBBBBBPBBPBBv
WBBBBBBBPBBBBBBBBBBBBBBBBBBBBBBBBBBBBBBBBBBBBBBBBBBBBBBBBBBBBBBBBBBBBDBBBBBBBBBBBBBBBBBBBPBBBBBBBBBBBBBBBBBBBBBBv
WBBBBBBBBBBBBBBBBBBBBBBBBBBBBBBBBBBBBBBBBBBBBBBBBBBHBBBBBBBBBBBBBBBBBBBBBBBBBBBBBBBBBBBBBBBBBBBBBBBBBBBBBBBBBBBBv
WBBBBBBBBBBBBBBBBBBBBBBBBBBBBBBBBBBBBBBBBBBBBBBBBBBDBBBBBBBBBBBBBBBBBBBBBBBBBBBBBBBBBBBBBBBBBBBBBBBBBBBBBBBBBBBBv
WBB1BBBBBBBBBBBBBBBBBBBBBBBBBBBBBBBBBBBBBBBBBBBBBBBuBBBBBBBBBBBBBBBBBuBBBBBBBBBBBBBBBBBBBBBBBBBBBBBBBBBBBBBBBBBBv
WBBBBBBBBBBBBBBBMMMBBSSSSSBBMMMBBBBlBBBBmBBBrBBBBBBBBBBBBBGBBRBGBBBMMMBBBBSSSBBBBBBBBBBBBBBBBBBBBBBBBBBBRBSSGBBBv
PBBPBBPBBPBBPBBPBBPBBPBBPBBPBBPBBPBBBBBBBBBBBPBBPBBPBBPBBPBBPBBPBBPBBPBBPBBPBBPBlBBBBBBBBmBBBBBBBBBBBBrPBBPBBPBBv
vBBvBBvBBvBBvBBvBBvBBvBBvBBvBBvBBvBBBBBBBBBBBvBBvBBvBBvBBvBBvBBvBBvBBvBBvBBvBBvBBBBBBBBBBBBBBBBBBBBBBBBBBBBBBBBBv
vBBvBBvBBvBBvBBvBBvBBvBBvBBvBBvBBvBBBBBBBBBBBvBBvBBvBBvBBvBBvBBvBBvBBvBBvBBvBBvBBBBBBBBBBBBBBBBBBBBBBBBBBBBBBBBBv


