WBBBBBBBBBBBBBBBBBBBBBBBBBBBBBBBBBBBBBBBBBBBBBBBBBBBBBBBBBBBBBBBBBBBBBBv
WBBBBBBBBBBBBBBBBBBBBBBBBBBBBBBBBBBBBBBBBBBBBBBBBBBBBBBBBBBBBBBBBBBBBBBv
WBBBBBBBBBBBBBBBBBBBBBBBBBBBBBBBBBBBBBBBBBBBBBBBBBBBBBBBBBBBBBBBBBBBBBBv
WBBBBBBBBBBBBBBBBBBBBBBBBBBBBBBBBBBBBBBBBBBBBBBBBBBBBBBBBBBBBBBBBBBBBBBv
WBBBBBBBBBBBBBBBBBBBBBBBBBBBBBBBBBBBBBBBBBBBBBBBBBBBBBBBBBBBBBBBBBBBBBBv
WBBBBBBBBBBBBBBBBBBBBBBdBBBBSBHBSBBBBdBBBSBBBMMBBBBBBBBBBBBGBBBBBBBGBSBv
WBBBBBBBBBBBBBBBBBBBBBBBBBBPBBPBBPBBBBBBBPBBPBBPBBlBBBBBBBBmBBBBBBrBPBBv
WBBBBBBBBBBBBBBBBBBBBBBBBB5BBBBBBBEBBBBBBBBBBBBBBBBBBBBBBBBBBBBBBBBBBBBv
WBBBBBBBBBBBBBBBBBBBBBBGBBBBBBBBBBBBBBBBBBBBBBBBBBBBBBBBBBBBBBBBBBBBBBBv
WBBBBBBBBBBBBBBBBBBBBBBDBBBBBBBBBBBBBBBBBBBBBBBBBBBBBBBBBBBBBBBBBBBBBBBv
WBBBBBBBBBBBBBBBBBBBBBBBBBBBBBTBBBBBBBBBBBBBBBBBBBBBBBBBBBBBGBMBBBBBBBBv
WBBBBBBBBBBBBBBBBBBBBBBBBBBPBBPBBPBBBBBBBBBBBBBBBBBBBBBBBBBBPBBPBBBBBBBv
WBBBBBBBBBBBBBBBBBBBBBBBBBBBBBBBBBBBBDBBBBBBBBBBBBBBBBBBBBBEBBBBBBBBBBBv
WBBBBBBBBBBBBBBBBBBBBBBBBBBBBBBBBBBBBBBBBBBBBBBBBBBBBBHBBBBBBBBBBBBBBBBv
WBBBBBBBBBBBBBBBBBBBBBBuBBBBBBBBBBBBBBBBBBBBBBBBBBBBBBPBBBBBBBBBBBBBBBBv
WBBBBBBBBBBBBBBBBBBBBBBBBBBBBBBBBBBBBBBBBBBBBBBBBBBBBBBBBBBBeBBBBSASBBBv
WBBBBBBBBBBBBBBBGBSSSSSGBBBBBBBBBBBBBBBBBBBBBBBBBBBBBBBBBBBBPBBPBBPBBPBB
WB1BBBBBBBBBBBBBBPBBPBBPBBBBBBBBBBBBBBBBBBBBBBBBBBBBBBBBBBBBBBBBBBBBBBBv
WBBBBBBBBBBBBBBBBBBBBBBBBBBBBBBBBBBBBBBBBBMBRBMBBSSSBBBBBBBBBBBBBBBBBBBv
PBBPBBPBlBBBBBmBBBBBBBrBBBBBBBBBBBBBBBBBBPBBPBBPBBPBBPBBBBBBBBBBBBBBBBBv
vBBvBBvBBBBBBBBBBBBBBBBBBBBBBBBBBBBBBuBBBvBBvBBvBBvBBvBBBBBBBBBBBBBBBBBv



