WBBBBBBBBBBBBBBBBBBBBBBBBBBBBBBBBBBBBBBBBBBBBBBBBBBBBBBBBBBBBv
WBBBBBBBBBBBBBBBBBBBBBBBBBBBBBBBBBBBBBBBBBBBBBBBBBBBBBBBBBBBBv
WBBBBBBBBBBBBBBBBBBBBBBBBBBBBBBBBBBBBBBBBBBBBBBBBBBBBBBBBBBBBv
WBBBBBBBBBBBBBBBBBBBBGBeGBBBBBBBBBBBBBBBBBBBBBBBBBBBBBBBBBBBBv
WBBBBBBBBBBBBBBBBBBBBPBBPBBBBBBBBBBBBBBBBBBBBBBBBBBBBBBBBBBBBv
WBBBBBBBBBBBBBBBBBBB4BBBB3BBBBBBBBBBBBBBBBBBBBBBBBBBBBBBBBBBBv
WBBBBBBBBBBBBBBBBBBBBBBBBBBBBBBBBBBBBBBBBBBBBBBBBBBBBBBBBBBBBv
WBBBBBBBBBBBBBBBBBGBBBBgBBBBBBBBBBBBBBBBBBBBBBBBBBBBBBBBBBBBBv
WBBBBBBBBBBBBBBBBBPBBPBBPBBPBlBBBBBmBBBBBBBBrBBBBBBBBBBBBBBBBv
WBBBBBBBBBBBBBBBBBBBBBBBBBBBBBBBBBBBBBBBBBBBBBBBBBBBBBBBBBBBBv
WBBBBBBBBBBBBBBBBBBBBBBBBBBBBBBBBBBBBBBBBBBBBBBBBBBBBBBBBBBBBv
WBBBBBBBBBBBBBBBBBBBBBBBBBBBBBBBBBBBBBBBBBBBBBBBBBBBBBBBBBBBBv
WBSSBBBBBBBBBBBBBBBBBBBBBBBBBBBBBBBBBBBBBBBBBBGBBBMMMBBBBBTBBv
WPBBPBBBBBBBBBBBBBBBBBBBBBBBBBBBBBBBBBBBBBBBBBPBBPBBPBBPBBPBBv
WBBBBBBBBBBBBBBBBBBBBBBBBBBBBBBBBBBBBBBBBBBBBBBBBBBBBBBBBBBBBv
WBBBBBBBBBBBBBBBBBBBBBBBBBBBBBBBBBBBBBBBBBBBBBBBBBBBBBBBBBBBBv
WBB1BBBBBBBBBBBBBBBBBBBBBBBBBBBBBBBBBBBBBBBBBBBBBBBBBBBBBBBBBv
WBBBBBBBBBBBBMBSHSBBBGBGBGBBMMMBBBBBBBBBBMMBBBBBBBBBSASASBBBBv
PBBPBBPBBBBBPBBPBBPBBPBBPBBPBBPBBPBBBBBBBPBBPBBPBBPBBPBBPBBPBv
vBBvBBvBBBBBvBBvBBvBBvBBvBBvBBvBBvBBBBBBBvBBvBBvBBvBBvBBvBBvBv



