WBBBBBBBBBBBBpBBBBBpBBBBBBBBBBBBBBBBBBB
WBBBBBBBBBBBBpBBBBBpBBBBBBBBBBBBBBBBBBB
WBBBBBBBBBBBB2BBBBB2BBBBBBBBBBBBBBBBBBB
WBBBBBBBBBBBBBBBBBBBBBBBBBBBBBBBBBBBBBB
WBBBBBBBBBBBBEBBBBBEBBBBBBBBBBBBBBBBBBB
W1BBBBBdBBBBSBBBTBBBSBBBBBBBBBBBBBBBBBB
WPBBPBBBBBPBBPBBPBBPBBPBBPBBBBBBBdBBBBB
WBBBBBBBBBBBBBBBBBBBBBBBBBBBBBBBBBBBBBB
WBBBBBBBBBBBBBBBBBBBBBBBBBBBBBBBBBBBBBB
WBBBBBBBBBBBBBBBBBBBBBBBBBBBBBBBBBBBBBB
WBBBBBBDBBBBBBBBBBBBBBBBBBBBBBBBBBBBBBB
WBBBBBBBBBBBBBBBBBBBBBBBBBBBBBBBBBBBBBB
WBBBBBBBBBBBBBBBBBBBBBBBBBBBBBBBBBBBBBB
WBBBBBBBBBBSSBBBBBBdBBBBBGBBBBBBBBBBBBB
WPBBPBBBBBPBBPBBPBBBBBPBBPBBBBBBBBBBBBB
WBBBBBBBBBBBBBBBBBBBBBBBBpBBBBBBBBBBBBB
WBBBBBBBBBBBBBBBBBBDBBBBBpBBBBBBBBBBBBB
WBBBBBBBBBBBBBBBBBBBBBBBBpBBBBBBBGBBBBB
WBBBBBBBBBBBBBBBBBBBBBBBBpBBBBBBBDBBBBB
WBBBBBBBBBBBBBBBBBBBBBBBBpBBBBBBBBBBBBB
WBBBBBBBBBBBBBBBBBBBBBBBBpBBBBBBBBBBBBB
WBBBBBBBBBBBBBBBBBBBBBBBBpBBBBBBBBBBBBB
WSBGBBBuBBBBBBBBeBBBBBBeBpBBSSBBBuBBBBB
WPBBPBBPBBPBBPBBPBBuBBPBBpBBPBBPBBPBBPB
WpBBpBBpBBpBBpBBpBBBBBpBBpBBpBBpBBpBBpB




