WBBBBBBBBBBBBBBBBBBBBBBBBBBBBBBBBBBBBBBBBBBBBBBBBBBBBBBBBBBBBBBBBBBBBBBB
WBBBBBBBBBBBBBBBBBBBBBBBBBBBBBBBBBBBBBBBBBBBBBBBBBBBBBBBBBBBBBBBBBBBBBBB
WBBBBBBBBBBBBBBBBBBBBBBBBBBBBBBBBBBBBBBBBBBBBBBBBBBBBBBBBBBBBBBBBBBBBBBB
WBBBBBBBBBBBSBBBBBBBBBSBBBBBBBB1BBBBBBBBBBBBBBBBBBBBBBBBBBBBBBBBBBBBBBBB
WBBBBBBBBBBBBBBBBBBBBBBBBBBBBBBBBBBBBBBBBBBBBBBBBBBBBBBBBBBBBBBBBBBBBBBB
WBBBBBBBBBBBBBBBBBBBBBBBBBBBBBBBBBBBBBBBBBBBBBBBBBBBBBBBBBBBBBBBBBBBBBBB
WBBBBBBBBBBBBBBBBSBBBBBBBBBBBBBBBBBBBBBBBBBBBBBBBBBBBBBBBBBBBBBBBBBBBBBB
WPBBPBBPBlBBBBBBBmBBBBBrBPBBPBBPBBBBBBBBBBBBBBBBBBBBBBBBBBBBBBBBBBBBBBBB
WpBBpBBpBBBBBBBBBBBBBBBBBpBBpBBpBBBBBBBBBBBBBBBBBBBBBBBBBBBBBBBBBBBBBBBB
WpBBpBBpBMMMMMMMMMMMMMMMBpBBpBBpBBBBBBBBBBBBBBBBBBBBBBBBBBBBBBBBBBBBBBBB
WpBBpBBpBBPBBPBBPBBPBBPBBpBBpBBpBBBBBBBBBBBBBBBBBBBBBBBBBBBBBBBBBBBBBBBB
WpBBpBBpBBpBBpBBpBBpBBpBBpBBpBBpBBBBBBBBBBBBBBBBBBBBBBBBBBBBBBBBBBBBBBBB
WBBBBBBBBBBBBBBBBBBBBBBBBBBBBBBBBBBBBBBBBBBBBBBBBBBBBBBBBBBBBBBBBBBBBBBB
WBBBBBBBBBBBBBBBBBBBBBBBBBBBBBBBBBBBBBBBBBBBBBBBBBBBBBBBBBBBBBBBBBBBBBBB
WBBBBBBBBBBBBBBBBBBBBBBBBBBBBBBBBBBBBBBBBBBBBBBBBBBBBBBBBBBBBBBBBBBBBBBB
WBBBBBBBBBBBBBBBBBBBBBBBBBBBBBBBBBBBBBBBBBBBBBBBBBBBBBBBBBBBBBBBBBBBBBBB
WBBBBBBBBBBBBBBBBBBBBBBBBBBBBBBBBBBBBBBBBBBBBBBBBBBBBBBBBBBBBBBBBBBBBBBB
WBBBBBBBBBBBBBBBBBBBBBBBBBBBGBBBBBBBBBBBBBBBBBBBBBBBBBBBBBBBBBBBBBBBBBBB
WBBBBBBBBBBBBBBBBBBBBBBBBBBBBBBBBBBBBBBBBBBBBBBBBBBBBBBBBBBBBBBBBBBBTBBB
WPBBPBBPBBPBBPBBPBBPBBPBBPBBPBBPBBPBBPBBPBBPBBPBBPBBPBBPBBPBBPBBPBBBBBBB
WBBBBBBBBBBBBBBBBBBBBBBBBBBBBBBBBBBBBBBBBBBBBBBBBBBBBBBBBBBBBBBBBBBBBBBB
WBBBBBBBBBBBBBBBBBBBBBBBBBBBBBBBBBBBBBBBBBBBBBBBBBBBBBBBBBBBBBBBBBBBBBBB