WBBBBBBBBBBBBBBBBBBBBBBBBBBBBBBBBBBBBBBBBp
WBBBBBBBBBBBBBBBBBBBBBBBBBBBBBBBBBBBBBBBBp
WBBBBBBBBBBBBBBBBBBBBBBBBBBBBBBBBBBBBBBBBp
WBBBBBBBBBBBBBBBBBBBBBBBBBBBBBBBBBBBBBBBBp
WBBBBBBBBBBBBBBBBBSSBBBBBBBBBBBBBBBBBBBBBp
WBBBBBBBBBBBBBBBBPBBPBBBBBBBBBBBBBBBBBBBBp
WBBBBBBBBBBBBBBBBBBBBBBBBBBBBBBBBBBBBBBBBp
W1BBBBBBBBBBBBBBBBBBBBBBBBBBBBBBBBBBBBBBBp
WPBlBBBBBBBBBBBBBBBBmBBBBBBBBBBBBBBBBBrPBp
WpBBBBBBBBBBBBBBBBBBBBBBBBBBBBBBBBBBBBBBBp
WpBBBBBBBBBBBBBBBBBBBBBBBBBBBBBBBBBBBBBBBp
WpBMMMMMMMMMMMMMMMMMMMMMMMMMMMMMMBBBBBBBBp
W2BB2BB2BB2BB2BB2BB2BB2BB2BB2BB2BBBBBBBBBp
WBBBBBBBBBBBBBBBBBBBBBBBBBBBBBBBBBBBBBBBBp
WBBBBBBBBBBBBBBBBBBBBBBBBBBBBBBBBBBBBBBBBp
WBBBBBBBBBBBBBBBBBBBBBBBBBBBBBBBBBBBBBBBBp
WBBBBBBBBBBBBBSBBBBBBBBSBBBBBBBBBBBBBBBBBp
WBBBBBBBBBBBBBBBBBBBBBBBBBBBBBBBBBBBBBBBBp
WBTBBBBBBBBBBBBBBBBBBBBBBBBBBBBBBBBBBBBBBp
WPBBPBBBBBBBBBBBBBBBBBBBBBBBBBBBBBBPBBPBBp
WpBBpBBBBBSBBBBBBBSBBBBBBBBBBSBBBBBpBBpBBp
WpBBpBlBBBBBBBBBBBBBBmBBBBBBBBBBBBrpBBpBBp
WpBBpBBBBBBBBBBBBBBBBBBBBBBBBBBBBBBpBBpBBp
WpBBpBBBBBBBBBBBBBBBBBBBBBBBBBBBBBBpBBpBBp
W2BB2BBBBBBBBBBBBBBBBBBBBBBBBBBBBBB2BB2BBp